XXXXXXX                 XXXXXXXXXXX
              XXXXX
          XXXXXXXXX
       XXXXXXXXXXXX
    XXXXXXXXXXXXXXX
XXXXXXXXX
XXXXXXXXX
XXXXXXXXX
XXXXXXXXX
XXXXXXXXX